1111111111111111111111111111111111
1E00000000F0000C00000C000000000001
101001010010000F101001000000010101
1010010010101010001001000000010101
1P0000000C00C000000000000F000000C1
1111111111111111111111111111111111